11111111
100000P1
10011111
1C111111
1C111111
10111111
10000011
1Y000011
11111E11
11111111