11111111111
100000000P1
10011111111
10000000001
1000C000001
11111111101
10000000001
1C000000001
11111011111
10000000001
11111111111