1111111111111
1000000000001
1001111111111
1000000P00001
1000C00000001
1111111111101
1000000000001
1C00000000001
1111101111111
1E00000000001
1111111111111