11111111
1E111111
10000001
11111101
1C0000P1
11111111