11111111111
1E00C011111
1110Y111111
11000111111
111C0011111
1111100YC11
111YC000011
1111100P111
11111111111