1111
10E1
1011
10C1
10Y1
10C1
1101
1101
1101
1101
11C1
1P01
1111