1111111111111
10000000000C1
11111111P0001
1000000000001
1111111111111